



				NO							 ./Texture/wall-3d


    WE                   ./Texture/ahmez-za

					SO               ./Texture/wall-3d









          


                                    




EA    ./Texture/wall-3d 



F               50,100,	1



C       225,30, 0





        1111111111111111111111111
        1000000000110000000000001
        1011000001110000000000001
        1001000000000000000000001
111111111011000001110000000000001
100000000011000001110111111111111
111101111E1111011100000010001
111101111111110110111010010001
11000000110101011100000010001
1000000000000000110000001001
10000000000000001101010010001
1100000111010101111101111000111
11110111 1110101 101111010001
11111111 1111111 111111111111
