



NO                    ./Texture/wall-3d



                      SO               ./Texture/wall-3d





    WE                   ./Texture/wall-3d




          







EA    ./Texture/wall-3d 





F               1,100,1



   C       225,30, 0







        1111111111111111111111111
        1000000000110000000000001
        1011000001110000000000001
        1001000000000000000000001
111111111011001101110000000000001
100000000011001 1111011111000111
1111011E0111111111000000100011  
11110111111111011101010010001
1100000011010101110000010001
10000000000000001100000010001
10000000000000001101010010001
1100000111010101101101111000111
11110111 1110101 11111010001
11111111 1111111 11111111111