NO ./path_to_the_north_texture
SO ./path_to_the_south_texture
WE ./path_to_the_west_texture
EA ./path_to_the_east_texture

F 220,100,0
C 225,30,0


11111111111111111111111
100000000001110000000N1
11111111011111111111111
111    10111        111
       111
       111
111    10111        111
10111111011111111111101
11111111111111111111111
