NO ./path_to_the_north_texture
SO ./path_to_the_south_texture
WE ./path_to_the_west_texture
EA ./path_to_the_east_texture

F 220,100,0
C 225,30,0



                        111111111111 1111111111
                        100000000001 10000000N1
                        111111110111 1111111101
                        111    101          111
                               111
                               111
                        111    101          111
                        101111111111 1111111101
                        111111111111 1111111111
